NO ./texture/n_wall.xpm
SO ./texture/s_wall.xpm
WE ./texture/w_wall.xpm
EA ./texture/e_wall.xpm

F 100,100,100
C 100,100,100

        111111111111111111111111111111111111111111111111111111111111111111111111111111111111111111111111111111111111111111111111111111111111
        1W0000000000000000000000000000000000000000000000000000000000000000000000000000000000000000000000000000000000000000000000000000000001
        101111111111111111111111111111111111111111111111111111111111111111111111111111111111111111111111111111111111111111111111111111111111
        101
        101
        101
        101
        101
        101
        101
        101
        101
        101
        101
        101
        101
        101
        101
        101
        101
        101
        101
        101
        101
        101
        101
        101
        101
        101
        101
        101
        101
        101
        101
        101
        101
        101
        101
        101
        101
        101
        101
        101
        101
        101
        101
        101
        101
        101
        101
        101
        101
        101
        101
        101
        101
        101
        101
        101
        101
        101
        101
        101
        101
        101
        101
        101
        101
        101
        101
        101
        101
        101
        101
        101
        101
        101
        101
        101
        101
        101
        101
        101
        101
        101
        101
        101
        101
        101
        101
        101
        101
        101
        101
        101
        101
        101
        101
        101
        101
        101
        111
