NO ./texture/w_wall.xpm
SO ./texture/s_wall.xpm
WE         
EA ./texture/e_wall.xpm

F 100,100,100
C 100,100,100

        1111
        1W01
        1001
        1111
