NO ./texture/n_wall.xpm
SO ./texture/s_wall.xpm
WE ./texture/w_wall.xpm
EA ./texture/e_wall.xpm

C 100,100,100,100
F 100,100,100

        1111
        1W01
        1001
        1111
